filename, language, JavaScript, Markdown, comment, blank, total
array\README.md, Markdown, 0, 39, 0, 11, 50
array\array.js, JavaScript, 61, 0, 51, 8, 120
distances\README.md, Markdown, 0, 31, 0, 13, 44
distances\distances.js, JavaScript, 62, 0, 55, 11, 128
graph\README.md, Markdown, 0, 52, 0, 10, 62
graph\bellman-ford.js, JavaScript, 63, 0, 21, 7, 91
graph\dijkstra.js, JavaScript, 105, 0, 19, 24, 148
graph\graph.js, JavaScript, 6, 0, 57, 8, 71
graph\shortestpath.js, JavaScript, 39, 0, 25, 9, 73
map\README.md, Markdown, 0, 27, 0, 5, 32
map\map.js, JavaScript, 61, 0, 34, 8, 103
random\README.md, Markdown, 0, 18, 0, 9, 27
random\random.js, JavaScript, 22, 0, 30, 5, 57
statistics\README.md, Markdown, 0, 18, 0, 6, 24
statistics\statistics.js, JavaScript, 46, 0, 17, 3, 66
Total, -, 465, 185, 309, 137, 1096